****X*****
XX*XXX*X*X
XX*****X*X
XXXXXXXX*X
**********
XXXX*XXXXX
******X***
*****X**X*
*X******X*
