***X*X***X*************X*****X
XX*X*X*X*X*X*XXXXXXXXX*X*XXX*X
*X*X***X*X*X*****X***X*X***X*X
*X*XXX*X*X*XXXXX*XXX*X*XXXXX*X
*X***X*X***X*****X***********X
*XXX*X*XXXXX*XXXXX*XXXXXXXXX*X
*X***X*****X*X*****X*********X
*X*XXXXXXX*X*XXX*X*X*XXXXXXX*X
***X*****X*X***X*X***X*****X*X
*XXX*X*XXX*XXX*X*XXXXX*XXX*X*X
*X*X*X*****X*X*X*X*********X*X
*X*X*XXXXXXX*X*XXX*XXXXX*XXX*X
*X***X*******X***X*X*****X*X*X
*X*XXXXXXX*X*XXX*X*X*XXXXX*X*X
*X*****X*******X***X*X*******X
*XXXXX*X*XXXXX*XXXXX*XXXXX*XXX
*X***X***X***X*X***X*****X*X*X
*X*X*XXXXX*X*X*X*X*XXXXX*X*X*X
***X*X*****X*****X*****X*X***X
XXXX*XXX*XXXXXXXXXXXXXXX*XXX*X
***X***X***X*************X***X
*X*XXX*XXXXX*XXXXXXXXXXXXX*XXX
*X***X*******X*X*******X***X*X
*X*X*XXXXXXXXX*X*X*XXXXX*XXX*X
*X*X*X*****X***X*X***X***X***X
*X*XXX*X*XXX*X*X*XXX*X*XXX*X*X
*X***X*X***X*X***X***X***X*X*X
*XXX*X*XXX*X*XXXXX*X*XXX*X*X*X
***X*****X*********X*******X*X
XXXXXXXXXXXXXXXXXXXXXXXXXXXX**
