...#.#...#.............#.....#
##.#.#.#.#.#.#########.#.###.#
.#.#...#.#.#.....#...#.#...#.#
.#.###.#.#.#####.###.#.#####.#
.#...#.#...#.....#...........#
.###.#.#####.#####.#########.#
.#...#.....#.#.....#.........#
.#.#######.#.###.#.#.#######.#
...#.....#.#...#.#...#.....#.#
.###.#.###.###.#.#####.###.#.#
.#.#.#.....#.#.#.#.........#.#
.#.#.#######.#.###.#####.###.#
.#...#.......#...#.#.....#.#.#
.#.#######.#.###.#.#.#####.#.#
.#.....#.......#...#.#.......#
.#####.#.#####.#####.#####.###
.#...#...#...#.#...#.....#.#.#
.#.#.#####.#.#.#.#.#####.#.#.#
...#.#.....#.....#.....#.#...#
####.###.###############.###.#
...#...#...#.............#...#
.#.###.#####.#############.###
.#...#.......#.#.......#...#.#
.#.#.#########.#.#.#####.###.#
.#.#.#.....#...#.#...#...#...#
.#.###.#.###.#.#.###.#.###.#.#
.#...#.#...#.#...#...#...#.#.#
.###.#.###.#.#####.#.###.#.#.#
...#.....#.........#.......#.#
############################..
