....#.....
##.###.#.#
##.....#.#
########.#
..........
####.#####
......#...
.....#..#.
.#......#.
